''
's
0ex
1ex
1mark
25MB
Ament's
Cross'
Limberlost
PDF
Stratton
X11
YYYY
cement'
coloralias
colour
constrainable
emacs
fixup
formatters
headingcolor
horizonal
hyperref
idx
kcolorchooser
kcoloredit
lab1
lab17
lab3
lettercase
lexicographically
makeindex
nondefault
pdflatex
readers'
redeclare
redefinitions
rgb
royalblue3
showrgb
startup
tgbonum
toc
underfull
utahred
uuthesis
uuthesis2e
verbatimcolor
whitespace
zi4
